dt(15)VN	Hexamer	Timepoint
AACGTGAT	GATAGACA	D1
AAACATCG	GCCACATA	D1
ATGCCTAA	GCGAGTAA	D2
AGTGGTCA	GCTAACGA	D2
ACCACTGT	GCTCGGTA	D4
ACATTGGC	GGAGAACA	D4
CAGATCTG	GGTGCGAA	D7
CATCAAGT	GTACGCAA	D7
CGCTGATC	GTCGTAGA	D10
ACAAGCTA	GTCTGTCA	D10
CTGTAGCC	GTGTTCTA	D14
AGTACAAG	TAGGATGA	D14
AACAACCA	TATCAGCA	D1
AACCGAGA	TCCGTCTA	D1
AACGCTTA	TCTTCACA	D2
AAGACGGA	TGAAGAGA	D2
AAGGTACA	TGGAACAA	D4
ACACAGAA	TGGCTTCA	D4
ACAGCAGA	TGGTGGTA	D7
ACCTCCAA	TTCACGCA	D7
ACGCTCGA	AACTCACC	D10
ACGTATCA	AAGAGATC	D10
ACTATGCA	AAGGACAC	D14
AGAGTCAA	AATCCGTC	D14
AGATCGCA	AATGTTGC	D1
AGCAGGAA	ACACGACC	D1
AGTCACTA	ACAGATTC	D2
ATCCTGTA	AGATGTAC	D2
ATTGAGGA	AGCACCTC	D4
CAACCACA	AGCCATGC	D4
GACTAGTA	AGGCTAAC	D7
CAATGGAA	ATAGCGAC	D7
CACTTCGA	ATCATTCC	D10
CAGCGTTA	ATTGGCTC	D10
CATACCAA	CAAGGAGC	D14
CCAGTTCA	CACCTTAC	D14
CCGAAGTA	CCATCCTC	D1
CCGTGAGA	CCGACAAC	D0
CCTCCTGA	CCTAATCC	D2
CGAACTTA	CCTCTATC	D0
CGACTGGA	CGACACAC	D4
CGCATACA	CGGATTGC	D0
CTCAATGA	CTAAGGTC	D7
CTGAGCCA	GAACAGGC	D0
CTGGCATA	GACAGTGC	D10
GAATCTGA	GAGTTAGC	D0
CAAGACTA	GATGAATC	D14
GAGCTGAA	GCCAAGAC	D0